// toki a
types:
	0=#
	1=kasi
	2=nasin
	3=nasin
	4=seli
	5=telo
	6=telo
	7=leko
	8=lupa
	09=ma
	10=jan
	11=kala
	80=kasi
	81=soweli
	98=soweli
	99=ala
/types
player:98
interactable:5,6,8,10,81,77
collidable:1,2,4,7,11
map: // the static game world
01010101010202020202020101010101010101010101010101010101010101060606060606010101010101010101010101010101010101010101010101010101010101010101010199
01010101010202020202020101010101010101010101010101010101010101060606060606010101010101010101010101010101010101010101010101010101010101010101010199
01010101010202020202020101010101010101010101010101010101010101060606060606010101010101010101010101010101010101010101010101010101010101010101010199
01010101010202020202020101010101010101010101010101010101010101060606060606010101010101010101010101010101010101010101010101010101010101010101010199
01010101010202020202020101010101010101010101010101010101010101060606060606010101010101010101010101010101010101010101010101010101010101010101010199
01010101010202020202020101010101010101010101010101010101010101060606060606010101010101010101010101010101010101010101010101010101010101010101010199
01010101010303030303030101010101010101010101010101010101010101060606060606010101010101010101010101010101010101010101010101010101010101010101010199
01010101010003000303000101010101010101010101010101010101010101060606060606010101010101010101010101010101010101010101010101010101010101010101010199
01010101010300000300000101010101010101010101010101010101010101060606060606010101010101010101010101010101010101010101010101010101010101010101010199
01010101010000030000030101010101010101010101010101010101010101060606060606010101010101010101010101010101010101010101010101010101010101010101010199
01010101010000000000000101010101010101010101010101010101010101060606060606010101010101010101010101010101010101010101010101010101010101010101010199
01010101010000000000000101010101010101010101010101010101010101060606060606010101010101010101010101010101010101010101010101010101010101010101010199
01010101010000000000000101010101010101010101010101010101010101060606060606010101010101010101010101010101010101010101010101010101010101010101010199
01010101010000000000000101010101010101010101010101010101010101060606060606010101010101010101010101010101010101010101010101010101010101010101010199
01010101010000000000000101010101010101010101010101010101010101060606060606010101010101010101010101010101010101010101010101010101010101010101010199
01010101010000000000000101010101010101010101010101010101010101060606060606010101010101010101010101010101010101010101010101010101010101010101010199
01010101010000000000000101010101010101010101010101010101010101060606060606010101010101010101010101010101010101010101010101010101010101010101010199
01010101010000000000000001010101010101010101010101010101010101060606060606010101010101010101010101010101010101010101010101010101010101010101010199
01010101000000000000000000000101010101010101010101010101010101060606060606010101010101010101010101010101010101010101010101010101010101010101010199
01010101000000001000000000000101010101010101010101010101010101050505050505010101010101010101010101010101010101010101010101010101010101010101010199
01010101000000100400100000000101010101010101010101010101010101050505050505010101010101010101010101010101010101010101010101010101010101010101010199
01010101000000000000000000000101010101010101010101010101010101050505050505000000010101010101010101010101010101010101010101010101010101010101010199
01010101000000000000000000000101010101010101010101010101010101050505050505008100010101010101010101010101010101010101010101010101010101010101010199
01010101010000000000000000010101010101010101010101010101010101050505050505000000010101010101010101010101010101010101010101010101010101010101010199
01010101010000000000000101010101010101010101010101010101010101050505050505000000010101010101010101010101010101010101010101010101010101010101010199
01010101010000000000000101010101010101010101010101010101010101050505050505010101010101010101010101010101010101010101010101010101010101010101010199
01010101010100000000000001010101010101010101010101010101010101050505050505010101010101010101010101010101017777777777770101010101010101010101010199
01010101010100000000000001010101010101010101010101010101010101050505050505010101010101010101010101010101010000000000000101010101010101010101010199
01010101010100000000000001010101010101010101010101010101010101050505050505010101010101010101010101010101010000000000000101010101010101010101010199
01010101010100000000000001010101010101010101010101010101010101050505050505010101010101010101010101010101010001000000000101010101010101010101010199
01010101010100000000000001010101010101010101010101010101010101050505050505010101010101010101010101010101000000000000010101010101010101010101010199
01010101010100000000000001010101010101010101010101010101010101050505050505010101010101010101010101010000000000000001000101010101010101010101010199
01010101010100000000000001010101010101010101010101010101010101050505050505010101010101010101010100010000000100000000010101010101010101010101010199
01010101010101010000000000000000000000000000000000000101010101050505050505010101010100000000000000000000000000000001010101010101010101010101010199
01010101010101010000000000000000000000000000000000000000000000050505050505000000010000000000000000000000000000000101010101010101010101010101010199
01010101010101010000000000000000000000000000000000000000000000050505050505000000000000000001000000000001000101010101010101010101010101010101010199
01010101010101010000000000000000000000000000000000000000000000050505050505000000000001000000000000000000010101010101010101010101010101010101010199
01010101010101010000000000000000000000000000000000000000000000050505050505000000000000000000000001010101010101010101010101010101010101010101010199
01010101010101010000000000000000000000000000000000000000000000050505050505000000000000000001010101010101010101010101010101010101010101010101010199
01010101010101010101010000000000000001010000000000000000000000050505050505010101010101010101010101010101010101010101010101010101010101010101010199
01010101010101010101010000000000000101010100000000000000000005050505050606010101010101010101010101010101010101010101010101010101010101010101010199
01010101010101010101010000000000000101010100000000000000000005050505060606060601010101010101010101010101010101010101010101010101010101010101010199
01010101010101010101000000000000000101010100000000000000000005050505060606060606010101010101010101010101010101010101010101010101010101010101010199
01010101010101010101000000000001010101010101000000000000000005050505060606060606060101010101010101010101010101010101010101010101010101010101010199
01010101010101010101000000000001010101010101010000000000000505050506060606060606060601010101010101010101010101010101010101010101010101010101010199
01010101010101010101000000000101010101010101010000000000000505050506060606060606060606010101010101010101010101010101010101010101010101010101010199
01010101010101010101010101010101010101010000000000000000000505050506060606060606060606010101010101010101010101010101010101010101010101010101010199
01010101010101010101010101010101010101000000000000000000000505050606060606060606060606010101010101010101010101010101010101010101010101010101010199
01010101010101010101010101010101010001000000000000000000000505050606060606060606060606010101010101010101010101010101010101010101010101010101010199
01010101010101010101010101010100000000000000000000000000000505050606060606060606060606010101010101010101010101010101010101010101010101010101010199
01010101010101010101010101010100000000000000000000000000000505050606060606060606060601010101010101010101010101010101010101010101010101010101010199
01010101010101010101010101010107070708070707000000000000000505050606060606060606060601010101010101010101010101010101010101010101010101010101010199
01010101010101010101010101010107000000000007010000000000000505050506060606060605050101010101010101010101010101010101010101010101010101010101010199
01010101010101010101010101010107000000000007010000000000000505050505060606060505000001010101010101010101010101010101010101010101010101010101010199
01010101010101010101010101010107000000000007010000000000000505050505050505050505000000010101010101010101010101010101010101010101010101010101010199
01010101010101010101010101010107000000000007010000000000000505050505050505050505000000000101010101010101010101010101010101010101010101010101010199
01010101010101010101010101010107070707070707010000000000000005050505050505050500000000010101010101010101010101010101010101010101010101010101010199
01010101010101010101010101010101010101010101010000000000000005050505050505050500000000010101010101010101010101010101010101010101010101010101010199
01010101010101010101010101010101010101010101010000000000000005050505050505050500000000010101010101010101010101010101010101010101010101010101010199
01010101010101010101010101010101010101010101010000000000000005050505050505050500000000000101010101010101010101010101010101010101010101010101010199
01010101010101010101010101010101010101010101010000000000000005050505050505050505000000000001010101010101010101010101010101010101010101010101010199
01010101010101010101010101010101010101010101010100000000000005050505050505050505000000000000010101010101010101010101010101010101010101010101010199
01010101010101010101010101010101010101010101010100000000000000050505050505050505050000000000000001010101010101010101010101010101010101010101010199
01010101010101010101010101010101010101010101010100000000000000050505050505050505050500000000000000000101010101010101010101010101010101010101010199
01010101010101010101010101010101010101010101010101000000000000000505050505050505050505000000000000000001010101010101010101010101010101010101010199
01010101010101010101010101010101010101010101010101000000000000000005050511100505050505050500000000000001010101010101010101010101010101010101010199
01010101010101010101010101010101010101010101010101010000000000000000000509090505050505050505050000000000000101010101010101010101010101010101010199
01010101010101010101010101010101010101010101010101010000000000000000000009090505050505050505050505050505050505010101010101010101010101010101010199
01010101010101010101010101010101010101010101010101010100000000000000000000000505050505050505050505050505050505060606060606060606060606010101010199
01010101010101010101010101010101010101010101010101010101000000000000000000000005050505050505050505050505050506060606060606060606060606010101010199
01010101010101010101010101010101010101010101010101010101010000000000000000000000000505050505050505050505050606060606060606060606060606010101010199
01010101010101010101010101010101010101010101010101010101010101010000000000000000000000000505050505050505050606060606060606060606060606010101010199
01010101010101010101010101010101010101010101010101010101010101010101010000000000000000000000000001010101010606060606060606060606060606010101010199
01010101010101010101010101010101010101010101010101010101010101010101010101010100000000000000000000808080808001010101010101010101010101010101010199
01010101010101010101010101010101010101010101010101010101010101010101010101010101010000000101000101010101018001010101010101010101010101010101010199
01010101010101010101010101010101010101010101010101010101010101010101010101010101010101010101010101010101018001010180808080808080810101010101010199
01010101010101010101010101010101010101010101010101010101010101010101010101010101010101010101010101010101018080808080010101010101010101010101010199
01010101010101010101010101010101010101010101010101010101010101010101010101010101010101010101010101010101010101010101010101010101010101010101010199
01010101010101010101010101010101010101010101010101010101010101010101010101010101010101010101010101010101010101010101010101010101010101010101010199
99999999999999999999999999999999999999999999999999999999999999999999999999999999999999999999999999999999999999999999999999999999999999999999999999
/map

dialog:(8,19) // jan 1
jan:  jan
/dialog
dialog:10 // jan
jan:  toki a
/dialog


dialog:5 // water
soweli li ken ala tawa lon telo
/dialog
dialog:6 // deep water
telo li anpa suli
soweli li ken ala tawa lon telo
/dialog

dialog:(18,51) // fishermans house
lupa:  lupa
/dialog

dialog:(37,65) // fisherman
jan:  toki
>add interactable 11
/dialog
dialog:(36,65) // fich
kala:  kala
>remove interactable 5
>remove interactable 11
>remove interactable 10
/dialog

dialog:(64,75) // secret soweli 1
soweli:  mu musi
/dialog
dialog:(38,22) // secret soweli 1
soweli:  mu musi
/dialog


dialog:77 // ending dialog
musi ni li pini
/dialog
