// toki a
types:
	0=ma
	1=kasi
	2=ijo
	3=kiwen
	11=jan
	33=telo
	99=soweli
/types
player:99
interactable:11,33
collidable:1,2,3
map: // the static game world
010101010101010101010101010101010101010101010101010101010101010101010101010101010101010101010101
010101010101010101010101010101010101010101010101010101010101010101010101010101010101010101010101
010101010101010101010101010101010101010101010101010101010101010101010101010101010101010101010101
010101010100000000000000000000000000000000000000000000000000000000000000000000000000000001010101
010101010100000000000011000202000000000000000000000000000000000000000000000000000000000001010101
010101010100000000000000000202030000000000000000000000000000000000000000000000000000000001010101
010101010100000000000000000003030300000000000000000000000000000000000000000000000000000001010101
010101010100000000000000333300030000000000000000000000000000000000000000000000000000000001010101
010101010100000000000000333300000000000000000000000000000000000000000000000000000000000001010101
010101010100000000000000000000000000000000000000000000000000000000000000000000000000000001010101
010101010100000000000000000000000000000000000000000000000000000000000000000000000000000001010101
010101010100000000000000000000000000000000000000000000000000000000000000000000000000000001010101
010101010101010101010101010101010101010101010101010101010101010101010101010101010101010101010101
010101010101010101010101010101010101010101010101010101010101010101010101010101010101010101010101
010101010101010101010101010101010101010101010101010101010101010101010101010101010101010101010101
/map
dialog:(11,4)
soweli:  toki|a
jan:soweli|o.toki|a
/dialog
dialog:33
soweli moku e telo
>remove interactable 33
/dialog
