// toki a
types:
	0=ma
	1=kasi
	2=ijo
	3=kiwen
	11=jan
	99=soweli
/types
player:99
interactable:11
collidable:1,2,3
map: // the static game world
0101010101010101010101010101010101010101010101010101010101010101010101010101010101
0100000000000000000000000000000000000000000000000000000000000000000000000000000001
0100000000000011000202000000000000000000000000000000000000000000000000000000000001
0100000000000000000202030000000000000000000000000000000000000000000000000000000001
0100000000000000000003030300000000000000000000000000000000000000000000000000000001
0100000000000000000000030000000000000000000000000000000000000000000000000000000001
0100000000000000000000000000000000000000000000000000000000000000000000000000000001
0100000000000000000000000000000000000000000000000000000000000000000000000000000001
0100000000000000000000000000000000000000000000000000000000000000000000000000000001
0100000000000000000000000000000000000000000000000000000000000000000000000000000001
0101010101010101010101010101010101010101010101010101010101010101010101010101010101
/map
dialog:7,2
soweli:toki|a
jan:soweli|o.toki|a
/dialog
